XXXXXXXXXXXXXXXXXXXXX
XS0000XXXXXXXXXXX0EEX
X000000XXXXXXXXX00EEX
XXXX000000000000000XX
XXXXX0000000000000XXX
XXXXXXXXXXXXXXXXXXXXX