XXXXXXXXXXXXXXXXXXXXXXXXX
XXXXXXX00000000000000XXXX
XXXXXXX000000000000000XXX
X00000000XXXXXXXXXX000EEX
XS000000XXXXXXXXXXXX00EEX
X000000XXXXXXXXXXXXXX0EEX
XXXXXXXXXXXXXXXXXXXXXXXXX