XXXXXXXXXXXXXXXXXX
XXXXX000000000XXXX
XXXXX0000000000XXX
X000000XXXXX000EEX
XS0000XXXXXXX00EEX
X0000XXXXXXXXX0EEX
XXXXXXXXXXXXXXXXXX